R 1920 1080
SO ./textures/purplestone.xpm
NO ./textures/greystone.xpm
WE ./textures/redbrick.xpm
EA ./textures/wood.xpm


S ./textures/creeper.xpm
F 77,92,23
C 54,208,2

		1111111111111111111111111
		1000000000110000000000001
		1011000001110000000000001
		1001000000000000000000001
111111111011000001110000000000001
100000000011000001110111111111111
111101111111110111000000100011
111101111111110111010100100011
11000000110101011100000010001
10000000000000001100000010001
1000000000S000001101010010001
1100000111010101111101111000111
11110111 1110101 101111010001
11111111 1111111 111111111111


          
          





		  