
NO ./assets/textures/creeper.xpm
SO ./assets/textures/south.xpm

WE ./assets/textures/west.xpm
EA ./assets/textures/redbrick.xpm

F 76,28,28
C 182,42,42

        1111111111111111111111111
        1000000000110000000000001
        101100000000000N000000001
        1001000000000000000000001
111111111011000001110000000000001
100000000011000001110111111111111
11110111111111011100000010001
1111011111111101 1101010010001
11000000110101011100000010001
10000000000000000000000010001
10000000000000000001010010001
1100000111010101111101111000111
11110111 1110101 101111010001
11111111 1111111 111111111111













