
NO ./assets/textures/ft_north.xpm
SO ./assets/textures/ft_south.xpm

WE ./assets/textures/ft_west.xpm
EA ./assets/textures/ft_eaaaa.xpm

F 142,95,24
C 43,234,224




1111111111111111111111111
100000000000000000000001
100000001000000000000001
100000000100000000000001
100000000000N00000000001
100000000000000000000001
100000000000000000000001
100000000000000000000001
111111111111111111111111












