
NO ./assets/textures/creeper.xpm
SO ./assets/textures/south.xpm

WE ./assets/textures/west.xpm
EA ./assets/textures/redbrick.xpm

F 76,28,28
C 182,42,42






11111111111111111111111
100000000000000000000001
100001000000000000100001
100010000000000000010001
100000000000N00000000001
100001000000000000100001
100000100000000001000001
100000000000000000000001
111111111111111111111111












