        11111111111111    1111111111111 11111
        1000000000110111110000000000001 100001
        101100000111111000000000000111  11111
        1001000001    10000000000000001
11111111101100000111111000000000000111   1
10000000001100000111011111111111111
11110111111111011100000010001
11110111111111011101010010001
1100000011010101110000001S001
1000000000000000110000001000111
10000000000000001101010010000001
1100000111010101111101111000111
11110111 1110101 101111010001
11111111111111111111111111111
111
111

